1,3,1,3,1,0,0,0,0,0,4,2,0,0,0,0,0,0,0,4
3,0,0,0,0,0,0,0,4,0,2,4,0,0,0,0,0,0,0,0
1,0,0,0,0,0,0,0,0,0,0,2,0,0,0,0,0,0,0,0
3,0,0,0,0,0,1,3,1,0,0,0,0,0,0,0,0,0,0,0
1,0,0,0,0,0,0,0,0,0,0,0,0,0,0,0,0,0,0,0
4,0,0,0,0,0,2,0,0,2,0,0,0,0,0,0,0,0,0,0
2,0,0,0,0,0,0,0,0,0,0,0,0,0,0,0,0,0,0,1
4,0,0,0,0,0,4,2,4,0,0,0,4,3,4,0,0,0,2,3
2,0,0,0,0,0,2,4,2,0,0,3,2,2,2,0,0,0,3,1
4,0,0,0,0,0,0,0,0,0,0,0,0,4,3,1,3,3,1,3
2,0,0,0,0,0,4,0,0,0,0,0,0,0,0,0,0,0,0,1
4,0,0,0,0,0,3,2,4,0,0,3,1,0,0,0,0,0,0,3
2,0,0,0,0,0,0,0,2,0,0,1,3,0,0,3,0,0,0,3
4,0,0,0,0,0,0,0,0,4,0,0,0,3,0,1,0,0,0,3
2,0,0,0,0,0,0,0,0,2,0,0,0,0,3,1,0,0,0,3
4,0,0,0,2,0,0,0,0,4,0,0,3,1,1,3,0,0,0,3
2,0,0,0,2,0,0,0,0,4,0,0,0,0,0,0,0,0,0,3
4,0,0,0,0,0,0,0,3,2,0,0,0,0,0,0,0,0,0,3
2,0,0,0,0,0,0,0,1,3,0,0,0,0,0,0,0,0,0,3
4,0,0,0,4,2,4,1,3,1,3,3,3,3,3,3,3,3,3,1
